w                              w
w       e                      w
w  w                           w
w      w                       w
w          w                   w
w              w               w
w                  w          ww
w                      w       w
w                          w   w
w                             ww
w                         w  w w
w                    w      w  w
w               w              w
w          w                   w
w     w                        w
wws                            w
w  w                           w
www                            w
