w                              w
w                              w
w                              w
w                              w
w                              w
w                              w
w                              w
w                 www          w
w     wwwwww                   w
w                              w
w w                    w   w   w
w                      t       w
w    wwwww ww wwwww wwwwwww e  w
w       n     n     n     n   ww
w    n     n     n     n    w  w
w s            w              ww
w  w          ww             w w
wwwwwwwwwwwwwwwwwwwwwwwwwwww www
