w                       www    w
w                      w   w   w
w                              w
w                              w
w                              w
w                              w
w                              w
w                              w
w                              |
w                              |
w                              |
w                            w |
w                             w|
w                            nw|
w                             w|
w s                          w |
w  w                           |
wwww     wwww     wwww     w  e|
